NO textures/NO.xpm
SO ./textures/SO.xpm
WE ./textures/WE.xpm
EA ./textures/EA.xpm

F 220, 100, 0
C 225,30,0

    1111111111111111111111111111
    101010101010101010101110101011
    10001000100010001000110010001
    10101010101010101010111111111
11111100100000001000000000101
101010100000000000101010101011
10101010100000001010101010101
10101010100000001010101010101
1000000000000000000000000101
100000001000N00010000000001011
10000000000000000000000000101
10101010100000001010101010101
10101010100000001010101010101
101010100000000000101010101011
10000000100000001000000000101
10101010111110101010101010101
1000100111 11001000100010101
1010101 0111 10101010101010101
11111111111 111111111111111111
