SO ./textures/SO.xpm
NO ./textures/NO.xpm
EA ./textures/EA.xpm
WE ./textures/WE.xpm

C 135,206,235

F 206,206,206


    11111111111111111111111111
    1000000000110000000000001
    1011000001110000E00000001
    1001000000000000000000001
111111111011000001110000000000001
101000000011000001110111000011111
11110111111111011100000010001
11110111111111011101010010001
11000000110101011100000010001
10000000000000001100000010001
100000001111100001101010010001
11000001     11111101111000111
11110111 1111101 101111010001
11111111 1111111 111111111111